11111111111111111111111111
1P000000000000000001CCCCC1
10000M0000M00000M001CCCCC1
10000000C00000000000000001
11111111111111110M00001111
10000000000000000000000001
10000000000000000M00000001
11111111010000000000000001
100E0M01010000000000000001
10000M00000010010000000001
11111111111111111111111111
