11111111111111111111111111111111111111111111111111111111111111111111111
1000000000P0000C00C00100000000011C00000000C000C000000100000000000000001
10000C0000111000000000000C00000110000C00000C0M0000000000000000000000001
10000C0000111000000000000C00000110000C000000C00000111100000000000000001
10000C0000111000000000000C000001111000000C00000011111100000000000000001
1000000000000000001111000000001C000000010000000011101100000000000000001
11111111111111000000000000000000000000000000000000000000000000000000001
10000000000000000000000000000000000000000000000000000000000000000000001
10111111111111111111111111111111111111111111111111111100000000000000001
1000000000000100000000000000000100000000000000000E000000000000000000001
10000000000001000100000000000001000000000000000000000000000000000000001
10000C00000000000100000000000000000000000000000000000000000000000000001
11111111111111111111111111111111111111111111111111111111111111111111111
